1111111111111
10010000000C1
1000010111001
1P0011E000001
1011111111111