1111111
10g0001
1P00001
1E0C001
1111111