111111
1000C1
100001
1P00E1
100001
111111