111111111111111111111111111
100000000000000000001000001
111000101000100010000100001
1C1010000000010000000100001
1000000000000P0000000000001
100000000000000000000000001
111100000010000000001000001
10000CE01111100000000000001
100000000000000000000000001
1000001000000C0000000001001
100100111001000111001000001
100100111001000111001000001
100100111001000111001000001
111111111111111111111111111