11111111111111111
10010000000C10001
10000000000000001
10000101110000011
1P0011E0000000111
11111111111111111