1111111111111
10000000000C1
11000P0111001
100011E000001
1111111111111