1111111111111111111111111
1000000000000000000010001
1110001010001000100001001
1C10100000000100000001001
1000000000000P00000000001
1000000000000000000000001
1111000000100000000010001
10000CE011111000000000001
1000000000000000000000001
1000001000000C00000000011
1001001110010001110010001
1001001110010001110010001
1001001110010001110010001
1111111111111111111111111