11111111111111111111111111
10000000000000000000100001
11100010100010001000010001
1C101000000001000000010001
1000000000000P000000000001
10000000000000000000000001
11110000001000000000100001
10000CE0111110000000000001
10000000000000000000000001
1000001000000C000000000011
10010011100100011100100001
10010011100100011100100001
10010011100100011100100001
11111111111111111111111111