11111111111
11000010001
10000000001
1P000000001
10000000E01
11111111111